अ - Utter
आ - Amen
इ - Itch
ई - Eat
उ - sOOt
ऊ - uuu, cUbe
ए - Ape
ऐ - At
ओ - Oats
औ - OWl
क - KArate
ख - KHan
ग - Gum
घ - Ghost
ङ - luNch
ह - Hut
च - CHuck
छ - CHHihuahua
ज - Jug
झ - JUob (job)
ञ - piNYata
य - Yeah
श - SHun
ट - Tug
ठ - Thamale
ड - Done
ढ - aDHere
ण - WRong
र - Run
ष - miSSIon
त - Talon
थ - THumb
द - Dab
ध - DHA
न - Nun
ल - Love
स - Sew
प - Puppet, Pritika
फ - P(H)ony
ब - Bum
भ - B(E)Hoove
म - Mother
व - Valor
ख़ - KHan (remove)
ग़ - Gutter (remove)
ज़ - Zebra
झ़ - xjn (remove)
ङ़ - rrnn (remove)
ढ़ - Rudder
फ़ - Fast
 ा- ‘aa’  का [kaa] is a combination of क + आ
 ि- ‘i’  कि [ki] is a combination of क + इ (k + i) 
ी - ‘ee’ की [kee] is a combination of क+ ई (k + ee)
 ु- ‘u’  कु [ku] is a combination of क + उ (k + u)
 ू- ‘oo’  कू [koo] is a combination of क + ऊ (k + oo)
 े- ‘ae’  के [kae] is a combination of क + ए (k + ae)
 ै- ‘aae’  कै [kaae] is a combination of क + ऐ (k + aae)
 ो- ‘o’  को [ko] is a combination of क + ओ (k + o)
 ौ- ‘au’  कौ [kau] is a combination of क+ औ (k + au)
 ृ- With ‘ri’  कृ [kri] is a combination of क +ऋ (k + ri)